##########
#G#      #
#        #
## P .   #
#        #
##########