##########
#G      G#
#   .    #
#  P  . .#
##########